.....XXXXXX.....
.....X0000X.....
.....X0000X.....
.....X0000X.....
.....X0000X.....
XXXXXX0000XXXXXX
X00000000000000X
X00000000000000X
X00000000000000X
X00000000000000X
XXXXXX0000XXXXXX
.....X0000X.....
.....X0000X.....
.....X0000X.....
.....X0000X.....
.....XXXXXX.....